TILEMAP
32 24
20 16
images/block.png
2 2
11111111111111111111111111111111
11111111111111111111111111111111
11111111111111111111111111111111
11111111111111111111111111111111
11                            11
11                            11
11                            11
11                            11
11  1111    1111    1111      11
11  1111    1111    1111      11
12  1111    1111    1111      11
12  1111    1111    1111      11
12                            11
12                            11
11                            11
11                            11
11  1111    1111    1111      11
11  1111    1111    1111      11
11  1111    1111    1111      11
11  1111    1111    1111      11
11                            11
11                            11
11111111111111111111111111111111
11111111111111111111111111111111