TILEMAP
32 24							-- Size of tile map in tiles
20 16							-- Tile size & block size
images/blocks.png	-- Tilesheet
2 2
11111111111111111111111111111111
11111111111111112222111111111111
11111111111111112222111111111111
11111111111111112222111111111111
1                              3
1                              3
1                              1
1                              1
1     11111111        11111111 1
1   1111111111      1111111111 1
1   1111111111      1111111111 1
1   1111111111      1111111111 1
1      11111                   1
1    1111111                   1
1    1111111                   1
1    111111                    1
1         11111111   1111111   1
1       1111111111   1111111   1
1       1111111111   1111111   1
1       1111111111             1
11111111111111111111111111111111
11111111111111111111111111111111
11111111111111111111111111111111
11111111111111111111111111111111