TILEMAP
32 24							-- Size of tile map in tiles
20 16							-- Tile size & block size
images/blocks.png					-- Tilesheet
2 2
11111111111111111111113333333311
1111111111111111111111        11
1111111111111111111111        11
1111111111111111111111        11
111111  111111111111          11
111111   11111111             11
111111        111             11
111111        111             11
111111               1111111  11
111111               1111111  11
11111111            11111111 111
11111111            1111111  111
111111    11111     1111111   11
111111  1111111               11
111111  1111111               11
111111  1111111                1
111111                         1
111111                        11
11111111                    1111
11111111                    1111
111111                     11111
111111                     11111
111111                     11111
11111122222222222222222222211111