TILEMAP
32 24							-- Size of tile map in tiles
20 16							-- Tile size & block size
images/blocks.png	-- Tilesheet
2 2
12222222222222222222222222222221
1			       1
1			       1
1			       1
1			       1
1			       1
1111111111111111111111111111   1
1111111111111111111111111111   1
1111111111111111111111111111   1
1111111111111111111111111111   1
1111111111111111111111111111   1
1111111111111111111111111111   1
1			       1
1			       1
111111111111111     11111111   1
111111111111111     11111111   1
111111111111111     11111111   1
111111111111111     11111111   1
111111111111111     11111111   1
111111111111111     11111111   1
1			       1
1			       1
11111111111111113333311111111111
11111111111111111111111111111111