TILEMAP
32 24							-- Size of tile map in tiles
20 16							-- Tile size & block size
images/blocks.png	-- Tilesheet
2 2
11111111111111111111111111111111
11111111111111111111111111111111
11111111111111111111111111111111
11111111111111111111111111111111
1                             11
1                             11
1                             11
1                             11
1       11111111              11
1       11111111              11
1       11111111    1111      11
1       11111111    1111      11
1   111111111111    1111      11
1   111111111111    1111      11
1   111111111111    1111      11
1   111111111111    1111      11
1   1111                      11
1   1111                      11
1   1111                      11
1   1111                      11
1                             11
1                             11
11111111111111111111111111111111
11111111111111111111111111111111