TILEMAP
32 24							-- Size of tile map in tiles
20 16							-- Tile size & block size
images/blocks.png	-- Tilesheet
2 2
11111111111111111111111111111111
11111111111111111111111111111111
11111111111111111111111111111111
11111111111111111111111111111111
11                            11
11                            11
11                            11
11                            11
11  1111    1111    1111      11
11  1111    1111    1111      11
11  1111    1111    1111      11
13  1111    1111    1111      11
13                            11
13                            11
13                            11
11                            11
11  1111    1111    1111      11
11  1111    1111    1111      11
11  1111    1111    1111      11
11  1111    1111    1111      11
11                            11
11                            11
11111111111111111111111111111111
11111111111111111111111111111111