TILEMAP
32 24							-- Size of tile map in tiles
20 16							-- Tile size & block size
images/blocks.png	-- Tilesheet
2 2
11111111111111111111111111111111
11111111111111111111111111111111
11111111111111111111111111111111
11111111111111111111111111111111
11111   1111              111111
11111   1111              111111
11111   1111              111111
11111   1111              111111
11111                     111111
11111                     111111
11111                     111111
11111                     111111
11111                     111111
11111                     111111
11111                     111111
11111                     111111
11111                     111111
11111                     111111
11111                     111111
111111111111    1111111111111111
111111111111    1111111111111111
111111111111    1111111111111111
111111111111    1111111111111111
11111111111122221111111111111111