TILEMAP
32 24							-- Size of tile map in tiles
20 16							-- Tile size & block size
images/blocks.png	-- Tilesheet
2 2
11111111111111111111111111111111
2			       1
2			       1
2			       1
2			       1
2			       1
1111111111111111111111111111   1
1111111111111111111111111111   1
1111111111111111111111111111   1
1111111111111111111111111111   1
1111111111111111111111111111   1
1111111111111111111111111111   1
1			       1
1			       1
111111111111111     11111111   1
111111111111111     11111111   1
111111111111111     11111111   1
111111111111111     11111111   1
111111111111111     11111111   1
111111111111111     11111111   1
1			       1
1			       1
1111111111111111     11111111111
11111111111111113333311111111111