TILEMAP
32 24							-- Size of tile map in tiles
20 16							-- Tile size & block size
images/blocks.png	-- Tilesheet
2 2
11111111111111111111111111111111
11111111111111111111111111111111
11111111111111111111111111111111
11111111111111111111111111111111
1                     1111111111
1                     1111111111
1                     1111111111
1                     1122222211
1                             11
1                             11
111  11111                    11
111  11111                    11
111  11111                    11
111  11111                    11
111  11111                    11
111  11111  11111  11111      11
1           11111  11111      11
1           11111  11111      11
1           11111  11111      11
1           11111  11111      11
1                             11
1                             11
1                             11
11111111111111111111111111111111