TILEMAP
32 24
8 8
images/blocks.png
2 2

11111111111111111111111111111111
11111111111111111111111111111111
11111111111111111111111111111111
11111111111111111111111111111111
11111111111111111111111111111111
11111111111111111111111111111111
11111111111111111111111111111111
11111111111111111111111111111111
11111111111111111111111111111111
11111111111111111111111111111111
11111111111111111111111111111111
11111111111111111111111111111111
11111111111111111111111111111111
11111111111111111111111111111111
11111111111111111111111111111  2
111111111111111                2
111111111111                   2
11111111111                    2
1111111111                     2
111111111                      2
111111111                      2
1111111111                     2
11111111111111111111111111111111
11111111111111111111111111111111
