TILEMAP
16 12
16 16
images/tilesOutside.png
24 16
0000000000000000
0000000000000000
0000000000000000
0000000000000000
0000000000000000
0000000000000000
0000000000000000
0000000000000000
0000000000000000
0111111111111110
0222222222222220
0333333333333330